あ	あ
い	い
う	う
お	お
か	か
が	が
く	く
け	け
こ	こ
さ	さ
し	し
じ	じ
す	す
ぜ	ぜ
た	た
だ	だ
ち	ち
っ	っ
つ	つ
で	で
ど	ど
な	な
ね	ね
の	の
ひ	ひ
ほ	ほ
ま	ま
ゃ	ゃ
よ	よ
ら	ら
り	り
れ	れ
わ	わ
ん	ん
